10 x 20
******************O*
*                  *
*     +     +      *
*     +  H  +      *
*   ++     *   *   *
*   *      *  *    *
*     * *    R  *  *
*  *           **  *
*     R      *     *
****O***************
