********************
*              *   *          
*                  *                  
*                  *                     
*                  *                    
*                  *                     
*                  *                     
*        *        R*                                     
*         RRRRRRRRR*                
********************